00000000000000000
01111111111111110
01111111111111110
01111111000010000
01111111000010000
01111111001111110
00000000001111110
00000000001111110
01111111121111100
01111111111111110
01111111111111110
01111111100111110
01111111110111110
01111111111111110
00000000000000000